10 10
SOOOOOOOOO
OXOXOXOXXO
OXOXOXOOOO
OOOOOXOOOO
OOOOOOOOOO
OXOXOXOXXO
OOOOOOOOOO
OXOXOXOXXO
OXOXOXOOOO
OOOOOXOOOW
